border_size=1
usage=map

Wo, Wo, Wo, Wo, Wo, Wo, Wo, Wo, Wo, Wo, Wo, Wo, Wo, Wo, Wo, Wo, Wo, Wo, Wo, Wo, Wo, Wo, Wo
Wo, Wo, Wo, Wo, Wo, Wo, Wo, Wo, Wo, Wo, Wo, Wo, Wo, Wo, Wo, Wo, Wo, Wo, Wo, Wo, Wo, Wo, Wo
Wo, Wo, Wo, Wo, Wo, Wo, Wo, Wo, Wo, Wo, Wo, Wo, Wo, Wo, Wo, Wo, Wo, Wo, Wo, Wo, Wo, Wo, Wo
Wo, Wo, Wo, Wo, Wo, Wo, Wo, Wo, Wo, Wo, Wo, Wo, Wo, Wo, Wo, Wo, Wo, Wo, Wo, Wo, Wo, Wo, Wo
Wo, Wo, Wo, Wo, Wo, Wo, Wo, Wo, Xuce, Xuce, Xuce, Wo, Wo, Wo, Wo, Wo, Wo, Wo, Wo, Wo, Wo, Wo, Wo
Wo, Wo, Wo, Wo, Wo, Wo, Xuce, Xuce, Re, Re^Vyb, Re, Xuce, Xuce, Wo, Wo, Wo, Wo, Wo, Wo, Wo, Wo, Wo, Wo
Wo, Wo, Wo, Wo, Wo, Wo, Xuce, Re, Ce, Ce, Ce, Re, Xuce, Wo, Wo, Wo, Xuce, Xuce, Xuce, Wo, Wo, Wo, Wo
Wo, Wo, Wo, Wo, Wo, Wo, Xuce, Re, Ce, 4 Ke, Ce, Re, Xuce, Wo, Wo, Xuce, Re, Re, Re, Xuce, Wo, Wo, Wo
Wo, Wo, Wo, Wo, Wo, Wo, Xuce, Re, Re, Ce, Re, Re, Xuce, Wo, Wo, Rd, Re, Re, Re, Rd, Wo, Wo, Wo
Wo, Wo, Wo, Wo, Wo, Wo, Wo, Xuce, Re, Re, Re, Xuce, Wo, Wo, Wo, Rd, Re, Xuce, Re, Rd, Wo, Wo, Wo
Wo, Wo, Wo, Wo, Wo, Wo, Wo, Rd, Re, Xuce, Re, Rd, Wo, Wo, Wo, Rd, Re, Re, Re, Rd, Wo, Wo, Wo
Wo, Wo, Wo, Wo, Wo, Wo, Wo, Rd, Re, Re, Re, Rd^Vyb, Wo^Bp\, Wo, Wo, Rd, Re, Re, Re, Rd, Wo, Wo, Wo
Wo, Wo, Wo, Wo, Wo, Wo, Wo, Rd, Re, Re, Re, Rd, Wo, Wo^Bp\, Wo^Bp\, Rd, Re, Xuce, Re, Rd, Wo, Wo, Wo
Wo, Wo, Wo, Wo, Wo, Wo, Wo, Rd, Re, Xuce, Re, Rd^Vyb, Wo^Bp\, Wo, Wo, 2 Rd^Vyb, Re, Re, Re, Rd, Wo, Wo, Wo
Wo, Wo, Wo, Wo, Wo, Wo, Wo, Rd, Re, Re, Re, Rd, Wo, Wo^Bp\, Wo^Bp\, Rd, Re, Re, Re, Rd, Wo, Wo, Wo
Wo, Wo, Wo, Wo, Wo, Wo, Wo, Rd, Re, Re, Re, Rd, Wo, Wo, Wo, 3 Rd^Vyb, Ce, Ce, Ce, Rd, Wo, Wo, Wo
Wo, Wo, Wo, Wo, Wo, Wo, Wo, Rd, Re, Re, Re, Rd, Wo, Wo, Wo, Rd, Ce, 1 Ke, Ce, Rd, Wo, Wo, Wo
Wo, Wo, Wo, Wo, Wo, Wo, Wo, Xuce, Xuce, Re, Xuce, Xuce, Wo, Wo, Wo, Re, Re, Ce, Re, Re, Wo, Wo, Wo
Wo, Wo, Wo, Wo, Wo, Wo, Wo, Wo, Wo, Xuce, Wo, Wo, Wo, Wo, Wo, Xuce, Xuce, Re, Xuce, Xuce, Wo, Wo, Wo
Wo, Wo, Wo, Wo, Wo, Wo, Wo, Wo, Wo, Wo, Wo, Wo, Wo, Wo, Wo, Wo, Wo, Xuce, Wo, Wo, Wo, Wo, Wo
Wo, Wo, Wo, Wo, Wo, Wo, Wo, Wo, Wo, Wo, Wo, Wo, Wo, Wo, Wo, Wo, Wo, Wo, Wo, Wo, Wo, Wo, Wo
Wo, Wo, Wo, Wo, Wo, Wo, Wo, Wo, Wo, Wo, Wo, Wo, Wo, Wo, Wo, Wo, Wo, Wo, Wo, Wo, Wo, Wo, Wo
