border_size=1
usage=map

Wo, Wo, Wo, Wo, Wo, Wo, Wo, Wo, Wo, Wo, Wo, Wo, Wo, Wo, Wo, Wo, Wo, Wo, Wo, Wo, Wo, Wo, Wo
Wo, Wo, Wo, Wo, Wo, Wo, Wo, Wo, Wo, Wo, Wo, Wo, Wo, Wo, Wo, Wo, Wo, Wo, Wo, Wo, Wo, Wo, Wo
Wo, Wo, Wo, Wo, Wo, Wo, Wo, Wo, Wo, Wo, Wo, Wo, Wo, Wo, Wo, Wo, Wo, Wo, Wo, Wo, Wo, Wo, Wo
Wo, Wo, Wo, Wo, Wo, Wo, Wo, Wo, Wo, Wo, Wo, Wo, Wo, Wo, Wo, Wo, Wo, Wo, Wo, Wo, Wo, Wo, Wo
Wo, Wo, Wo, Wo, Wo, Wo, Wo, Wo, Wo, Wo, Wo, Wo, Xuce, Xuce, Xuce, Wo, Wo, Wo, Wo, Wo, Wo, Wo, Wo
Wo, Wo, Wo, Wo, Wo, Wo, Wo, Wo, Wo, Wo, Xuce, Xuce, Re, Re^Vyb, Re, Xuce, Xuce, Wo, Wo, Wo, Wo, Wo, Wo
Wo, Wo, Wo, Wo, Xuce, Xuce, Xuce, Wo, Wo, Wo, Xuce, Re, Ce, Ce, Ce, Re, Xuce, Wo, Wo, Wo, Wo, Wo, Wo
Wo, Wo, Wo, Xuce, Re, Re, Re, Xuce, Wo, Wo, Xuce, Re, Ce, 4 Ke, Ce, Re, Xuce, Wo, Wo, Wo, Wo, Wo, Wo
Wo, Wo, Wo, Rd, Re, Re, Re, Rd, Wo, Wo, Xuce, Re, Re, Ce, Re, Re, Xuce, Wo, Wo, Wo, Wo, Wo, Wo
Wo, Wo, Wo, Rd, Re, Xuce, Re, Rd, Wo, Wo, Wo, Xuce, Re, Re, Re, Xuce, Wo, Wo, Wo, Wo, Wo, Wo, Wo
Wo, Wo, Wo, Rd, Re, Re, Re, Rd, Wo, Wo, Wo, Rd, Re, Xuce, Re, Rd, Wo, Wo, Wo, Wo, Wo, Wo, Wo
Wo, Wo, Wo, Rd, Re, Re, Re, Rd, Wo, Wo, Wo^Bp/, Rd^Vyb, Re, Re, Re, Rd, Wo, Wo, Wo, Wo, Wo, Wo, Wo
Wo, Wo, Wo, Rd, Re, Xuce, Re, Rd, Wo^Bp/, Wo^Bp/, Wo, Rd, Re, Re, Re, Rd, Wo, Wo, Wo, Wo, Wo, Wo, Wo
Wo, Wo, Wo, Rd, Re, Re, Re, 2 Rd^Vyb, Wo, Wo, Wo^Bp/, Rd^Vyb, Re, Xuce, Re, Rd, Wo, Wo, Wo, Wo, Wo, Wo, Wo
Wo, Wo, Wo, Rd, Re, Re, Re, Rd, Wo^Bp/, Wo^Bp/, Wo, Rd, Re, Re, Re, Rd, Wo, Wo, Wo, Wo, Wo, Wo, Wo
Wo, Wo, Wo, Rd, Ce, Ce, Ce, 3 Rd^Vyb, Wo, Wo, Wo, Rd, Re, Re, Re, Rd, Wo, Wo, Wo, Wo, Wo, Wo, Wo
Wo, Wo, Wo, Rd, Ce, 1 Ke, Ce, Rd, Wo, Wo, Wo, Rd, Re, Re, Re, Rd, Wo, Wo, Wo, Wo, Wo, Wo, Wo
Wo, Wo, Wo, Re, Re, Ce, Re, Re, Wo, Wo, Wo, Xuce, Xuce, Re, Xuce, Xuce, Wo, Wo, Wo, Wo, Wo, Wo, Wo
Wo, Wo, Wo, Xuce, Xuce, Re, Xuce, Xuce, Wo, Wo, Wo, Wo, Wo, Xuce, Wo, Wo, Wo, Wo, Wo, Wo, Wo, Wo, Wo
Wo, Wo, Wo, Wo, Wo, Xuce, Wo, Wo, Wo, Wo, Wo, Wo, Wo, Wo, Wo, Wo, Wo, Wo, Wo, Wo, Wo, Wo, Wo
Wo, Wo, Wo, Wo, Wo, Wo, Wo, Wo, Wo, Wo, Wo, Wo, Wo, Wo, Wo, Wo, Wo, Wo, Wo, Wo, Wo, Wo, Wo
Wo, Wo, Wo, Wo, Wo, Wo, Wo, Wo, Wo, Wo, Wo, Wo, Wo, Wo, Wo, Wo, Wo, Wo, Wo, Wo, Wo, Wo, Wo
