border_size=1
usage=map

Wo, Wo, Wo, Wo, Wo, Wo, Wo, Wo, Wo, Wo, Wo, Wo, Wo, Wo, Wo, Wo, Wo, Wo, Wo, Wo, Wo, Wo
Wo, Wo, Wo, Wo, Wo, Wo, Wo, Wo, Wo, Wo, Wo, Wo, Wo, Wo, Wo, Wo, Wo, Wo, Wo, Wo, Wo, Wo
Wo, Wo, Wo, Wo, Wo, Wo, Wo, Wo, Wo, Wo, Wo, Wo, Wo, Wo, Wo, Wo, Wo, Wo, Wo, Wo, Wo, Wo
Wo, Wo, Wo, Wo, Wo, Wo, Xuce, Xuce, Re, Wo, Wo, Wo, Wo, Wo, Wo, Wo, Wo, Wo, Wo, Wo, Wo, Wo
Wo, Wo, Wo, Wo, Wo, Xuce, Re, Re, Ce, Rd, Rd, Wo, Wo, Wo, Wo, Wo, Wo, Wo, Wo, Wo, Wo, Wo
Wo, Wo, Wo, Wo, Wo, Xuce, Re, Ce, 1 Ke, Ce, Re, Rd, Rd, Wo, Wo, Wo, Wo, Wo, Wo, Wo, Wo, Wo
Wo, Wo, Wo, Wo, Wo, Xuce, Re, Ce, Ce, Ce, Re, Re, Re, Rd, Rd, Wo, Wo, Wo, Wo, Wo, Wo, Wo
Wo, Wo, Wo, Wo, Wo, Wo, Wo, Rd, 3 Rd^Vyb, Re, Re, Re, Xuce, Re, Re, Rd, Rd, Wo, Wo, Wo, Wo, Wo
Wo, Wo, Wo, Wo, Wo, Wo, Wo, Wo, Wo^Bp|, Rd, 2 Rd^Vyb, Re, Re, Re, Re, Re, Re, Rd, Xuce, Wo, Wo, Wo
Wo, Wo, Wo, Wo, Xuce, Wo, Wo, Wo, Wo^Bp|, Wo, Wo^Bp|, Rd, Rd, Re, Re, Xuce, Re, Re, Xuce, Wo, Wo, Wo
Wo, Wo, Xuce, Xuce, Re, Rd, Rd, Wo, Wo^Bp|, Wo, Wo^Bp|, Wo, Wo, Rd, Rd, Re, Re, Re, Xuce, Wo, Wo, Wo
Wo, Wo, Xuce, Re, Re, Re, Re, Rd, Rd^Vyb, Wo, Wo^Bp|, Wo, Wo, Wo, Wo, Rd, Xuce, Xuce, Wo, Wo, Wo, Wo
Wo, Wo, Xuce, Re, Re, Re, Re, Re, Re, Rd, Rd^Vyb, Wo, Wo, Wo, Wo, Wo, Wo, Wo, Wo, Wo, Wo, Wo
Wo, Wo, Wo, Rd, Rd, Re, Re, Xuce, Re, Re, Re, Rd, Xuce, Xuce, Xuce, Wo, Wo, Wo, Wo, Wo, Wo, Wo
Wo, Wo, Wo, Wo, Wo, Rd, Rd, Re, Re, Re, Xuce, Re, Re, Re, Re, Xuce, Xuce, Wo, Wo, Wo, Wo, Wo
Wo, Wo, Wo, Wo, Wo, Wo, Wo, Rd, Rd, Re, Re, Re, Ce, Ce, Ce, Re, Xuce, Wo, Wo, Wo, Wo, Wo
Wo, Wo, Wo, Wo, Wo, Wo, Wo, Wo, Wo, Rd, Xuce, Re, Ce, 4 Ke, Ce, Re, Xuce, Wo, Wo, Wo, Wo, Wo
Wo, Wo, Wo, Wo, Wo, Wo, Wo, Wo, Wo, Wo, Xuce, Re, Re, Ce, Re, Re^Vyb, Xuce, Wo, Wo, Wo, Wo, Wo
Wo, Wo, Wo, Wo, Wo, Wo, Wo, Wo, Wo, Wo, Wo, Xuce, Xuce, Re, Xuce, Xuce, Wo, Wo, Wo, Wo, Wo, Wo
Wo, Wo, Wo, Wo, Wo, Wo, Wo, Wo, Wo, Wo, Wo, Wo, Wo, Xuce, Wo, Wo, Wo, Wo, Wo, Wo, Wo, Wo
Wo, Wo, Wo, Wo, Wo, Wo, Wo, Wo, Wo, Wo, Wo, Wo, Wo, Wo, Wo, Wo, Wo, Wo, Wo, Wo, Wo, Wo
Wo, Wo, Wo, Wo, Wo, Wo, Wo, Wo, Wo, Wo, Wo, Wo, Wo, Wo, Wo, Wo, Wo, Wo, Wo, Wo, Wo, Wo
